{
    "start": "2020-12-01T00:00:00",
    "data": [
        "144441144441144441144441",
        "433443334444444444444444",
        "443444434442244444444444",
        "443443334442244444111444",
        "443443444440044444411144",
        "433343334400004444441144",
        "444444444000000444441144",
        "444444444400004444411144",
        "444444444003000444111444",
        "444444440000000044444444",
        "444444400200000004444444",
        "444444444000020444444444",
        "444444440002000044444444",
        "444444400000000004444444",
        "444444000300030000444444",
        "444444440000000044444444",
        "444444400020002004444444",
        "444444030000300000444444",
        "444440000000000000044444",
        "444444402003000304444444",
        "444444000000000000444444",
        "444440000300020000044444",
        "444400000000000000004444",
        "444444444443344444444444",
        "444444323443344444444444",
        "000000323003300000000000",
        "000000323000000032300000",
        "000000000003230032300000",
        "000000000003230032300000",
        "000000000003230000000000",
        "001100001100001100001100"
    ]
}