{
    "start": "2020-12-01T00:00:00",
    "data": [
        "111111111111111111111111",
        "111111111112211111111111",
        "111111111112211111111111",
        "111111111110011111111111",
        "111111111100001111111111",
        "111111111000000111111111",
        "111111111100001111111111",
        "111111111003000111111111",
        "111111110000000011111111",
        "111111100200000001111111",
        "111111111000020111111111",
        "111111110002000011111111",
        "111111100000000001111111",
        "111111000300030000111111",
        "111111110000000011111111",
        "111111100020002001111111",
        "111111030000300000111111",
        "111110000000000000011111",
        "111111102003000301111111",
        "111111000000000000111111",
        "111110000300020000011111",
        "111100000000000000001111",
        "111111111113311111111111",
        "111111111113311111111111",
        "111111323113311111111111",
        "000000323000000032300000",
        "000000323003230032300000",
        "000000000003230032300000",
        "000000000003230000000000",
        "000000000000000000000000",
        "000000000000000000000000"
    ]
}