{
    "start": "2020-11-14T00:00:00",
    "data": [
        "012301230123012301230123",
        "333333333333333333333333",
        "222211121112111211122222",
        "000001001000100001000000",
        "333331331133111331333333",
        "222221221222221221222222",
        "000001001110111001000000",
        "333333333333333333333333"
    ]
}