{
    "start": "2021-01-01T00:00:00",
    "data": [
        "111111111111111111111111",
        "111111113111111111111111",
        "133111113311001111111113",
        "113111111331001111111113",
        "113111111131111111111131",
        "113111111131111111111111",
        "133311111131111331111111",
        "111111111231111331113111",
        "111001111222111111111111",
        "111000112222211100111111",
        "111100112222221100111111",
        "111101112222222111111111",
        "111011122222222111111110",
        "111011122222222211000001",
        "111111142222222220000111",
        "111111444222222000011111",
        "113311444422222002111111",
        "113311244442222222211111",
        "111112224444222222222111",
        "111142222444422222221111",
        "111142222244442222111121",
        "111144222224444211111111",
        "111444422222444111111111",
        "111244422222244111113311",
        "112224444221111001113311",
        "112224444111111001111111",
        "122222211111111111111331",
        "112211111111111111111331",
        "111111111111111111111111",
        "111111111111111111111111",
        "114411114411114411114411",
        "144441144441144441144441",
        "444444444442444444444444",
        "444444444442444444444444",
        "444444442222222444444444",
        "444444322333332234444444",
        "444443323333333233444444",
        "444433223333333223344444",
        "444333233333333323334444",
        "444333233322323323334444",
        "443332233223333322333444",
        "443332333333323332333444",
        "443332333323223332333444",
        "443332232223333322333444",
        "444333233333323323334444",
        "444333233332333323334444",
        "444433223333333223344444",
        "444443323333333233444444",
        "444444322333332234444444",
        "444444442333332444444444",
        "444444444222224444444444",
        "444444444222224444444444",
        "444444444222224444443334",
        "444444444222424444444434",
        "444444444243424444443334",
        "444444444242444444443444",
        "444444444442444444443334",
        "444444444442444444444444",
        "441144441144441144441144",
        "411114411114411114411114",
        "111111111111111111111111",
        "133311111111111111111111",
        "111311111111111111111111",
        "133311111111111111111111",
        "111311111111111111111111",
        "133311111111111111110001",
        "111111111000000001110001",
        "111111110000000000110001",
        "111111100000000000011011",
        "111111100000000000011111",
        "110001100000000000011111",
        "110001100000000000111111",
        "110001100000000000111111",
        "111011100000000000100011",
        "111111100000000000100001",
        "111111142222200000100011",
        "110000042344230000111111",
        "110000042342223444100001",
        "110000002344234444000001",
        "110000002222234440000001",
        "111000000000000000000011",
        "111100000000000000000111",
        "111111000000000000011111",
        "100011111000001111111111",
        "100001111111111111100011",
        "100011111111111111000011",
        "111111111111111111100011",
        "111111111111111111111111",
        "111111111111111111111111",
        "114411114411114411114411",
        "144441144441144441144441",
        "444444444444444444444444",
        "444444444444444444434344",
        "444444444444444444434344",
        "444444444444444444433344",
        "444444444444444444444344",
        "444444444444444444444344",
        "444444444444444444444444",
        "444444444444444444444444",
        "444444444444444444444444",
        "444444442222222244444444",
        "444444424444444424444444",
        "444444244444444442444444",
        "444444243344400442444444",
        "444444243311400442444444",
        "444444203313301142444444",
        "444442222222222222244444",
        "444423332222222233324444",
        "444422233333333332224444",
        "000002222222222222200000",
        "000002222222222222200000",
        "000002222222222222200000",
        "000000222211244222000000",
        "000000023311243320000000",
        "000000003441043300000000",
        "000000003440003300000000",
        "000000000440000000000000",
        "000000000000000000000000",
        "000000000000000000000000",
        "001100001100001100001100",
        "011110011110011110011110",
        "111111111111111111111111",
        "111111111111111111111111",
        "111111111111111111111111",
        "111111111111111111111111",
        "111111111111111111111111",
        "111111111444411111111111",
        "111111111411441111111111",
        "111111111111141111111111",
        "111111111111141111111111",
        "111111111111141111111111",
        "111111111111411111111111",
        "111111111144111111111111",
        "111111111141111111111111",
        "111111111141111111111111",
        "111111111141111111111111",
        "111111111111111111111111",
        "111111111111111111111111",
        "111111111111111111111111",
        "111111111141111111111111",
        "111111111144111111111111",
        "111111111111111111111111",
        "111111111111111111111111",
        "111111111111111111111111",
        "111111111111111111111111",
        "111111111111111111111111",
        "111111111111111111111111",
        "111111111111111111111111",
        "111111111111111111111111",
        "111111111111111111111111",
        "114411114411114411114411",
        "144441144441144441144441",
        "444444444444444444444444",
        "444444444444444444444444",
        "444444444444444444433344",
        "444444444444444444434444",
        "442334433443344444433344",
        "442333333333333444434344",
        "442223322332233444433344",
        "442222222222222444444444",
        "442002200220022444444444",
        "442000000000000444444444",
        "442110011001100444444444",
        "442111111111111444444444",
        "442441144114411444444444",
        "442444444444444444444444",
        "442444444444444444444444",
        "442444444444444444444444",
        "442444444444444444444444",
        "442444444444444444444444",
        "442444444444444444444444",
        "442444444444444444444444",
        "442444444444444444444444",
        "442444444444444344444444",
        "002000000000003230000000",
        "002000000003000300000000",
        "002000000032300000003000",
        "000100000003004000032300",
        "000100000000042400003000",
        "000010000000004000000000",
        "001110001100001100001100",
        "011110011110011110011110",
        "111111111111111111111111",
        "111111111111111111111111",
        "111111111111111111111111",
        "111111111111111111111111",
        "111111111111111111111111",
        "111111111444111111111111",
        "111111114411411111111111",
        "111111114111141111111111",
        "111111111111141111111111",
        "111111111111141111111111",
        "111111111111141111111111",
        "111111111114441111111111",
        "111111111114111111111111",
        "111111111114111111111111",
        "111111111114111111111111",
        "111111111111111111111111",
        "111111111111111111111111",
        "111111111111111111111111",
        "111111111111111111111111",
        "111111111141111111111111",
        "111111111141111111111111",
        "111111111111111111111111",
        "111111111111111111111111",
        "111111111111111111111111",
        "111111111111111111111111",
        "111111111111111111111111",
        "111111111111111111111111",
        "111111111111111111111111",
        "111111111111111111111111",
        "114411114411114411114411",
        "144441144441144441144441",
        "444444444444444444444444",
        "444444444444444444444444",
        "444444444444444444444444",
        "444444444444444444444444",
        "444444444444444444444444",
        "444444444444444444444444",
        "444444444111444444444444",
        "444444444141144444444444",
        "444444444444114444444444",
        "444444444444414444444444",
        "444444444444114444444444",
        "444444444444144444444444",
        "444444444441144444444444",
        "444444444111444444444444",
        "444444444444444444444444",
        "444444444444444444444444",
        "444444444444444444444444",
        "444444444444444444444444",
        "444444444111444444444444",
        "444444444111444444444444",
        "444444444444444444444444",
        "444444444444444444444444",
        "444444444444444444444444",
        "444444444444444444444444",
        "444444444444444444444444",
        "444444444444444444444444",
        "444444444444444444444444",
        "444444444444444444444444",
        "444444444444444444444444",
        "441144441144441144441144",
        "411114411114411114411114",
        "111111111111111111111111",
        "111111122222221111111111",
        "111122222222222222211111",
        "111222222222222222221111",
        "112222222222233322222111",
        "112333222222332222222211",
        "122222332222322233332211",
        "122222233222322332222221",
        "122222223322323322222221",
        "122222222333223222222221",
        "112222222233232222222321",
        "133333332233332222233321",
        "112222223323322223322211",
        "112222222333322232222111",
        "111222222233322322221111",
        "111122222233333222211111",
        "111111111133322221111111",
        "111111111133311111111111",
        "111333111133311111111111",
        "111313111133311111111111",
        "111333111333311111111111",
        "111113111333311111111111",
        "111333111333311111111111",
        "111111113333311111111111",
        "000002233333332222200000",
        "000023332232233333320000",
        "000022222233222222220000",
        "000002222223222222200000",
        "004400224422224422004400",
        "044440044442244440044440",
        "444444444444444444444444",
        "444444444444444433443334",
        "444444444444444443443434",
        "444444444444444443443434",
        "444444444444044443443434",
        "444444444440044433343334",
        "444444444400444444444444",
        "444444444400444444444444",
        "444442222222224444444444",
        "444422222222222244444444",
        "444222222222222222244444",
        "444222222222222222224444",
        "442222222222222222224444",
        "442222322222222232222444",
        "442222332222222332222444",
        "442222333222223332222444",
        "442222233223223322222244",
        "442222222233322222222244",
        "442232222222222222322244",
        "442232222222222232322444",
        "442233323222223233322444",
        "444223333333333333322444",
        "000223333333333333224444",
        "000022323232323232220000",
        "000002222222222222200000",
        "000000222222222220000000",
        "000000002222222000000000",
        "000000000000000000000000",
        "000000000000000000000000",
        "001100001100001100001100",
        "011110011110011110011110",
        "111111111111111111111111",
        "133113311111111111111111",
        "113111311111111111111111",
        "113111311111111111111111",
        "113111311111111111111111",
        "133313331122221111111111",
        "111111112204442211111111",
        "111111124403440421111111",
        "111111222433430222111111",
        "111111322224433223111111",
        "111111232222222232111111",
        "111112223322223322211111",
        "111124222233332222421111",
        "111244222222222222442111",
        "111240032222222224042111",
        "112224334222222430422211",
        "112222244444444433222211",
        "112332222244442222222211",
        "113233222222222222233311",
        "112223333322222333332211",
        "112222332333333322222211",
        "112222222222233222222211",
        "112222222222222222222211",
        "112222222222222222222211",
        "111222222222222222222111",
        "111112222222222222211111",
        "111111112222222211111111",
        "111111111111111111111111",
        "114411114411114411114411",
        "144441144441144441144441",
        "444444444444444444444444",
        "444111444442244433443334",
        "441114444442244443444434",
        "441144444440044443443334",
        "441144444400004443443444",
        "441114444000000433343334",
        "444111444400004444444444",
        "444444444003000444444444",
        "444444440000000044444444",
        "444444400200000004444444",
        "444444444000020444444444",
        "444444440002000044444444",
        "444444400000000004444444",
        "444444000300030000444444",
        "444444440000000044444444",
        "444444400020002004444444",
        "444444030000300000444444",
        "444440000000000000044444",
        "444444402003000304444444",
        "444444000000000000444444",
        "444440000300020000044444",
        "444400000000000000004444",
        "444444444443344444444444",
        "444444323443344444444444",
        "000000323003300000000000",
        "000000323000000032300000",
        "000000000003230032300000",
        "000000000003230032300000",
        "000000000003230000000000",
        "001100001100001100001100"
    ]
}